30 30 30 30 30 30 30 30 30 30 30 30 30 30 30 30 30 30 30 30 30 30 30 30 30 30 30 30 30 30 30 30 30 30 30 30 30 30 30 30 30 30 30 30 30 30 30 30 30 30 
30 30 30 30 30 30 30 30 30 30 30 30 30 30 30 30 30 30 30 30 30 30 30 30 30 30 30 30 30 30 30 30 30 30 30 30 30 30 30 30 30 30 30 30 30 30 30 30 30 30 
30 30 40 38 38 38 38 38 38 38 38 38 38 38 38 38 38 38 38 38 38 38 38 38 38 38 38 38 38 38 38 38 38 38 38 38 38 38 38 38 38 38 38 38 38 38 38 41 30 30 
30 30 36 15 15 15 15 15 12 12 12 12 12 12 12 12 12 12 12 12 12 12 12 12 12 12 12 12 12 12 12 12 12 12 12 12 15 15 15 15 15 15 15 15 15 15 15 35 30 30 
30 30 36 15 10 10 10 15 12 12 12 12 12 12 12 12 12 12 12 12 12 12 12 12 12 12 12 12 12 12 12 12 12 12 12 12 15 10 10 10 10 10 10 10 10 10 15 35 30 30 
30 30 36 15 10 10 10 15 12 12 12 12 12 12 12 12 12 12 12 12 12 12 12 12 12 12 12 12 12 12 12 12 12 12 12 12 15 10 10 10 10 10 10 10 10 10 15 35 30 30 
30 30 36 15 10 10 10 15 12 12 12 12 12 12 12 12 12 12 12 12 12 12 12 12 12 12 12 12 12 12 12 12 12 12 12 12 15 10 10 10 10 10 10 10 10 10 15 35 30 30 
30 30 36 15 10 10 10 15 12 12 12 12 12 12 12 12 12 32 33 33 33 33 33 33 33 33 33 33 33 34 12 12 12 12 12 12 15 10 10 10 10 10 10 10 10 10 15 35 30 30 
30 30 36 15 15 10 15 15 12 12 12 12 12 12 12 12 12 35 30 30 30 30 30 30 30 30 30 30 30 36 12 12 12 12 12 12 15 10 10 10 10 10 10 10 10 10 15 35 30 30 
30 30 36 12 15 10 15 12 12 12 12 12 12 12 12 12 12 35 30 30 31 30 30 30 30 30 31 30 30 36 12 12 12 12 12 12 15 10 10 10 10 10 10 10 10 10 15 35 30 30 
30 30 36 12 15 10 15 10 12 12 12 12 12 12 12 12 12 35 30 30 30 30 30 30 30 30 30 30 30 36 12 12 12 12 12 12 15 10 10 10 10 10 10 10 10 10 15 35 30 30 
30 30 36 12 12 10 10 10 10 10 12 12 12 12 12 12 12 35 30 31 30 30 30 31 30 30 31 30 30 36 12 12 12 12 12 12 15 10 15 15 15 15 15 15 15 15 15 35 30 30 
30 30 36 12 12 10 10 10 10 10 10 12 12 12 12 12 12 35 30 30 30 30 30 30 30 30 30 30 30 36 12 12 12 12 12 12 26 24 27 12 12 12 12 12 12 12 12 35 30 30 
30 30 36 12 12 12 10 10 10 10 10 10 12 12 12 12 12 37 38 38 38 38 38 38 38 38 38 38 38 39 12 12 12 12 12 12 22 16 21 12 12 12 12 12 12 12 12 35 30 30 
30 30 36 12 12 12 12 12 10 10 10 10 10 12 12 12 12 12 10 10 10 10 26 24 27 10 10 10 10 12 12 12 12 12 12 12 22 16 21 10 12 12 12 12 12 12 12 35 30 30 
30 30 36 12 12 12 12 12 10 10 10 10 10 12 12 12 12 12 12 10 10 10 22 16 21 10 10 10 12 12 12 12 12 12 12 12 22 16 21 10 10 10 12 12 12 12 12 35 30 30 
30 30 36 12 12 12 12 12 12 10 10 10 10 12 12 12 12 12 12 10 10 10 22 16 21 10 10 12 12 12 12 12 12 12 12 12 22 16 21 10 10 10 10 12 12 12 12 35 30 30 
30 30 36 12 12 12 12 12 12 12 10 10 10 10 12 12 12 12 12 10 10 10 22 16 21 10 10 12 12 12 12 12 12 12 12 12 22 16 21 10 10 10 10 10 12 12 12 35 30 30 
30 30 36 12 12 12 12 12 12 12 12 10 26 24 24 24 24 24 24 24 24 24 25 16 23 24 24 24 24 24 24 24 24 24 24 24 25 16 21 10 10 10 10 10 12 12 12 35 30 30 
30 30 36 12 12 12 12 12 12 12 12 10 22 16 17 17 17 17 17 17 17 17 17 16 17 17 17 17 17 17 17 17 17 17 17 17 17 16 21 10 10 10 10 10 12 12 12 35 30 30 
30 30 36 12 12 12 12 12 12 12 12 10 22 16 18 19 19 19 19 19 19 19 19 19 19 19 19 19 19 19 19 19 19 19 19 19 19 19 29 10 10 10 10 12 12 12 12 35 30 30 
30 30 36 12 12 12 12 12 12 12 12 10 22 16 21 12 12 12 12 12 12 12 12 12 12 12 12 12 12 12 12 12 12 12 12 12 12 10 10 10 10 10 12 12 12 12 12 35 30 30 
30 30 36 12 12 12 12 12 12 12 12 10 22 16 21 12 12 12 12 12 12 12 12 12 12 12 12 12 12 12 12 12 12 12 12 12 12 12 10 10 10 10 12 12 12 12 12 35 30 30 
30 30 36 12 12 12 12 12 12 12 12 10 22 16 21 12 12 12 15 15 15 15 15 15 15 15 15 15 15 15 15 15 15 15 12 12 12 12 10 10 10 10 12 12 12 12 12 35 30 30 
30 30 36 12 12 12 12 12 12 12 12 10 22 16 21 12 12 12 15 10 10 10 10 10 10 10 10 10 10 10 10 10 10 15 12 12 12 12 10 10 10 12 12 12 12 12 12 35 30 30 
30 30 36 12 12 12 12 12 12 12 12 10 22 16 21 12 12 12 15 10 10 10 10 10 10 10 10 10 10 10 10 10 10 15 12 12 12 12 10 10 10 12 12 12 12 12 12 35 30 30 
30 30 36 12 12 12 12 12 12 12 12 10 22 16 21 12 12 12 15 10 10 10 10 10 10 10 10 10 10 10 10 10 10 15 12 12 10 12 10 10 10 12 12 12 12 12 12 35 30 30 
30 30 36 12 12 12 12 12 12 12 12 10 22 16 21 12 12 12 15 10 10 10 10 10 10 10 10 10 10 10 10 10 10 15 12 12 12 12 12 10 10 10 12 12 12 12 12 35 30 30 
30 30 36 12 12 12 12 12 12 12 12 10 22 16 21 12 12 12 15 10 10 10 10 10 10 10 10 10 10 10 10 10 10 15 12 12 12 12 12 10 10 12 12 12 12 12 12 35 30 30 
30 30 36 12 12 12 12 12 12 12 12 10 22 16 21 12 12 12 15 10 10 10 10 10 10 10 10 10 10 10 10 10 10 15 12 12 12 12 12 10 10 12 12 12 12 12 12 35 30 30 
30 30 36 12 12 12 12 12 12 12 10 10 22 16 21 12 12 12 15 10 10 10 10 10 10 10 10 10 10 10 10 10 10 15 12 12 12 12 12 10 10 12 12 12 10 12 12 35 30 30 
30 30 36 12 12 12 12 12 12 12 10 10 22 16 21 12 12 12 15 15 15 15 15 15 15 24 24 15 15 15 15 15 15 15 12 12 12 12 12 10 10 12 12 12 12 12 12 35 30 30 
30 30 36 12 12 12 12 12 12 12 10 10 22 16 21 12 12 12 12 12 12 12 12 12 22 16 16 21 12 12 12 12 12 12 12 12 12 12 12 10 10 12 12 12 12 12 12 35 30 30 
30 30 36 12 12 12 12 12 12 12 10 10 22 16 21 12 12 12 12 12 12 12 12 12 22 16 16 21 12 12 12 12 12 12 12 12 12 12 12 10 10 10 12 12 12 12 12 35 30 30 
30 30 36 12 12 12 12 12 12 12 10 10 22 16 23 24 24 24 24 24 24 24 24 24 25 16 16 21 12 12 12 12 12 12 12 12 12 12 12 10 10 10 10 12 12 12 12 35 30 30 
30 30 36 12 12 12 12 12 12 12 10 10 22 16 17 17 17 17 17 17 17 17 17 17 17 16 16 21 10 10 10 10 10 10 10 10 10 10 10 10 10 10 12 12 12 12 12 35 30 30 
30 30 36 12 12 12 12 12 12 12 10 10 28 19 19 19 19 19 19 19 19 19 19 19 19 19 19 29 10 10 10 10 10 10 10 10 10 10 10 10 10 10 12 12 12 12 12 35 30 30 
30 30 36 12 12 12 12 12 12 12 10 10 10 10 10 10 10 10 10 10 10 10 10 10 10 10 10 10 10 10 10 10 10 10 10 10 10 10 10 10 10 12 12 12 12 12 12 35 30 30 
30 30 36 12 12 12 12 12 10 10 10 10 10 12 10 10 10 10 12 12 12 12 12 12 12 12 12 12 12 12 12 12 12 12 10 24 24 24 10 10 12 12 12 12 12 12 12 35 30 30 
30 30 36 12 12 12 12 10 10 10 10 10 10 10 10 10 10 12 12 12 12 12 12 12 12 12 12 12 12 12 12 12 12 12 12 15 15 15 10 15 15 15 15 15 15 15 15 35 30 30 
30 30 36 12 12 12 10 10 10 10 12 10 10 10 10 10 10 12 12 12 12 12 12 12 12 12 12 12 12 12 12 12 12 12 12 15 10 10 10 10 10 10 10 10 10 10 15 35 30 30 
30 30 36 12 12 12 10 10 10 10 10 10 10 10 10 10 10 12 12 12 12 12 12 12 12 12 12 12 12 12 12 12 12 12 12 15 10 10 10 10 10 10 10 10 10 10 15 35 30 30 
30 30 36 12 12 12 10 10 10 10 10 10 10 12 10 10 10 12 12 12 12 12 12 12 12 12 12 12 12 12 12 12 12 12 12 15 10 10 10 10 10 10 10 10 10 10 15 35 30 30 
30 30 36 12 12 12 12 10 10 10 10 10 10 10 10 10 12 12 12 12 12 12 12 12 12 12 12 12 12 12 12 12 12 12 12 15 10 10 10 10 10 10 10 10 10 10 15 35 30 30 
30 30 36 12 12 12 12 12 12 12 10 10 10 10 10 12 12 12 12 12 12 12 12 12 12 12 12 12 12 12 12 12 12 12 12 15 10 10 10 10 10 10 10 10 10 10 15 35 30 30 
30 30 36 12 12 12 12 12 12 12 12 12 12 12 12 12 12 12 12 12 12 12 12 12 12 12 12 12 12 12 12 12 12 12 12 15 10 10 10 10 10 10 10 10 10 10 15 35 30 30 
30 30 36 12 12 12 12 12 12 12 12 12 12 12 12 12 12 12 12 12 12 12 12 12 12 12 12 12 12 12 12 12 12 12 12 15 15 15 15 15 15 15 15 15 15 15 15 35 30 30 
30 30 42 33 33 33 33 33 33 33 33 33 33 33 33 33 33 33 33 33 33 33 33 33 33 33 33 33 33 33 33 33 33 33 33 33 33 33 33 33 33 33 33 33 33 33 33 43 30 30 
30 30 30 30 30 30 30 30 30 30 30 30 30 30 30 30 30 30 30 30 30 30 30 30 30 30 30 30 30 30 30 30 30 30 30 30 30 30 30 30 30 30 30 30 30 30 30 30 30 30 
30 30 30 30 30 30 30 30 30 30 30 30 30 30 30 30 30 30 30 30 30 30 30 30 30 30 30 30 30 30 30 30 30 30 30 30 30 30 30 30 30 30 30 30 30 30 30 30 30 30 
